0   0   0   0   0   0   0   0   0   0   0   0   0   0   0   0   0   0   0   0   0   0   0   0   0   0   0   0   0   0   0   0   255 0   0   0   0   0   0   0   0   0   1   1   0   0   0   0   0   0   0   0   0   0   0   0   0   0   0   0   0   1   255 0   0   0   0   1   0   0   0   1   0   0   0
0   0   0   0   0   0   0   0   0   0   0   0   0   0   0   0   0   0   0   0   0   0   0   0   0   0   0   0   0   0   0   0   0   0   0   0   0   6   0   0   0   0   1   3   0   0   0   0   0   0   0   0   0   0   0   0   0   0   0   0   0   0   1   255 0   0   0   1   0   0   0   1   0   0   0
0   0   0   0   0   0   0   0   0   0   0   0   0   0   0   0   0   0   0   0   0   0   0   0   0   0   0   0   0   0   0   0   0   0   0   0   0   1   4   0   0   0   0   0   0   2   1   0   0   0   0   0   0   0   0   0   0   0   0   0   1   255 0   1   255 0   0   1   0   0   0   1   0   0   0
0   0   0   0   0   0   0   0   0   0   255 0   0   0   0   0   0   0   0   0   0   0   0   0   0   0   0   0   0   0   0   0   0   0   0   0   0   0   0   0   1   5   1   1   1   1   0   0   0   0   0   0   5   1   4   0   0   0   0   0   0   1   255 0   1   255 0   1   0   0   0   1   0   0   0
0   0   0   0   0   0   0   0   0   0   0   0   0   0   0   0   0   0   0   0   0   0   0   0   1   0   0   0   0   0   0   0   0   1   0   1   0   5   1   1   3   0   0   0   0   0   0   1   0   0   0   1   0   0   0   1   0   0   0   1   255 0   1   255 0   1   0   1   0   1   0   1   0   0   0
0   0   0   0   0   0   0   0   0   0   0   0   0   0   0   0   0   0   0   0   0   1   0   1   3   0   0   0   0   0   0   0   1   3   0   3   0   0   3   3   0   0   0   0   0   0   0   0   0   0   0   0   0   0   0   0   0   0   0   0   1   255 0   1   0   0   0   1   1   0   1   1   0   0   0
0   0   0   0   0   0   0   0   1   0   0   0   0   0   0   0   0   0   0   0   0   3   0   3   0   0   0   0   1   0   1   0   3   0   0   0   0   0   0   0   0   0   0   0   0   0   1   0   0   0   0   0   1   0   0   0   0   0   0   0   0   1   0   0   0   0   0   1   0   0   0   1   0   0   0
0   0   0   0   0   0   0   1   1   0   0   0   0   0   0   0   0   0   0   1   0   0   0   0   0   0   0   1   3   0   3   0   0   0   0   0   0   0   0   0   0   0   0   0   0   0   0   0   1   0   0   1   0   0   0   0   0   0   0   0   0   0   1   0   0   0   0   0   0   0   0   0   0   0   8
0   0   0   0   0   0   1   1   1   1   0   0   0   0   0   0   0   0   0   3   0   0   0   0   0   0   0   3   0   0   0   0   0   0   0   0   0   0   0   0   0   2   9   6   9   0   1   0   0   0   0   0   0   0   0   0   0   0   0   0   0   0   0   0   0   0   0   0   0   0   0   0   0   0   1   
0   0   0   0   0   1   1   1   1   0   0   0   0   0   0   0   0   1   0   0   0   0   0   0   0   0   0   0   0   0   0   0   0   0   0   0   0   0   0   0   0   1   1   1   1   0   0   0   0   0   0   0   0   0   0   0   0   0   0   0   0   0   0   0   0   0   0   0   0   0   0   0   0   1   1   
0   0   0   0   1   1   1   1   1   0   1   0   0   0   0   0   0   3   0   0   0   0   0   0   0   0   0   0   0   0   0   0   0   0   0   0   0   0   0   0   0   0   0   0   0   0   0   0   0   0   0   0   0   0   0   0   0   0   2   0   0   0   0   0   0   0   0   0   0   2   0   0   1   1   1   
0   0   9   1   1   1   1   1   1   0   0   0   0   0   0   1   2   0   2   9   2   9   2   9   0   2   2   0   0   2   0   2   0   0   2   0   2   2   0   0   0   0   2   2   2   2   2   2   2   2   2   2   2   2   2   2   0   1   1   255 255 255 255 255 255 255 255 255 1   1   0   1   1   1   1 
